0 ./assets/dirt.png
1 ./assets/grass.jpg
2 ./assets/nonarea.jpg
3 ./assets/water.jpg
4 ./assets/dark.png
-1
36 28
1 1 2 2 2 2 2 2 2 2 2 2 2 2 2 2 2 2 2 2 2 2 2 2 2 2 2 2 2 2 2 2 2 2 2 2
1 1 1 1 0 0 0 0 0 0 0 0 0 0 0 0 0 0 0 0 2 0 0 0 0 0 1 2 1 1 1 1 1 1 1 2
2 1 1 1 0 0 0 0 0 0 0 0 0 0 1 0 0 0 0 0 2 0 0 0 0 1 1 2 1 1 1 1 1 1 1 2
2 1 1 1 1 0 0 0 0 0 0 0 0 0 0 0 1 0 0 0 2 0 0 0 0 0 1 2 2 1 1 1 1 1 1 2
2 1 1 1 1 1 0 0 0 0 0 0 0 0 0 0 0 0 0 1 2 0 0 0 0 0 0 1 2 1 1 1 1 1 1 2
2 2 2 2 2 2 0 0 0 2 2 2 2 2 2 1 1 1 1 1 2 0 0 0 0 0 0 0 2 1 1 1 1 1 1 2
2 1 1 1 1 0 0 0 0 2 1 1 3 3 2 1 1 1 1 1 2 0 0 0 0 2 2 2 2 2 2 2 1 1 1 2
2 1 1 1 0 0 0 0 0 2 0 1 3 3 2 1 1 1 1 1 2 0 0 0 0 0 0 0 0 0 0 0 0 0 1 2
2 2 2 2 2 2 2 2 2 2 0 0 3 3 0 0 0 0 0 0 2 0 0 0 0 0 0 0 0 0 0 0 0 0 0 2
2 1 1 0 0 0 0 0 0 0 0 0 3 3 0 0 0 0 0 0 2 0 0 0 0 0 0 0 0 0 0 0 0 0 0 2
2 1 1 0 0 0 0 0 0 0 0 0 3 3 0 0 0 0 0 0 2 0 0 0 2 2 2 2 2 2 2 2 2 2 2 2
2 0 0 0 0 0 0 0 0 0 2 2 2 2 2 2 2 2 2 2 2 0 0 0 2 1 1 1 1 1 3 3 0 1 1 2
2 0 0 0 0 0 0 0 0 1 2 0 0 0 0 0 1 1 1 1 0 0 0 0 2 1 1 1 1 1 3 3 0 0 1 2
2 0 0 0 2 2 2 2 2 2 2 0 0 0 0 0 1 1 1 1 0 0 0 0 2 1 1 1 1 1 3 3 0 0 0 2
2 0 0 0 0 0 0 0 0 0 0 0 0 0 0 1 1 1 1 0 0 0 0 0 2 2 2 2 2 2 2 2 0 0 0 2
2 0 0 0 0 0 0 0 0 0 0 0 0 1 0 1 1 1 1 0 0 0 0 0 0 0 0 0 0 0 0 0 0 0 0 2
2 3 3 0 0 0 0 0 0 0 0 0 0 0 0 0 1 1 1 2 2 0 0 0 0 0 0 0 0 0 0 0 0 0 0 2
2 3 3 0 0 0 0 0 1 2 2 2 2 2 2 2 2 2 2 2 0 0 0 0 0 0 0 0 0 0 0 0 0 0 0 2
2 2 2 2 2 2 2 2 2 2 1 0 0 0 0 0 0 0 0 0 0 0 0 0 0 0 0 0 0 0 0 0 0 0 0 2
2 1 1 0 0 0 0 0 0 0 0 0 0 1 0 0 0 0 0 1 0 0 0 0 2 2 2 2 2 2 2 2 2 2 2 2
2 0 0 0 0 0 0 0 0 0 0 0 0 0 0 0 3 3 3 1 0 0 0 0 0 0 0 0 0 0 0 0 0 0 0 2
2 0 0 0 0 0 0 0 0 0 0 0 0 0 0 0 3 3 3 0 0 0 0 0 0 0 0 0 0 0 0 0 0 0 0 2
2 1 1 1 1 1 2 0 0 0 0 0 0 0 0 0 3 3 3 0 0 0 0 0 0 0 0 0 0 0 0 0 0 0 0 2
2 1 1 1 1 1 2 0 0 2 2 2 2 2 2 2 2 2 2 2 2 2 2 2 2 2 2 2 2 0 0 0 0 0 0 2
2 1 1 1 1 1 2 0 0 0 0 0 0 0 0 0 0 0 0 0 0 1 1 1 1 1 1 1 2 0 0 0 0 0 0 2
2 1 1 1 1 1 2 0 0 0 0 0 0 0 0 0 0 0 0 0 1 1 1 1 1 1 1 1 2 0 0 0 0 0 0 2
2 1 1 1 1 1 2 1 1 1 1 1 0 0 0 0 0 0 0 1 1 1 1 1 1 1 1 1 2 0 0 0 0 0 0 2
2 2 2 2 2 2 2 2 2 2 2 2 2 2 2 2 2 2 2 2 2 2 2 2 2 2 2 2 2 2 2 2 2 2 2 2
-1
0 1 1
1 7 2
2 1 7
3 25 26
4 12 25
5 10 6
6 17 6 
8 18 2
8 2 24
8 31 2
8 28 22
8 28 18
7 4 24
7 6 4
-1
0 4 3
0 3 10
1 16 14
2 3 22
3 34 24
-1
