0 ./assets/dirt.png
1 ./assets/grass.jpg
2 ./assets/nonarea.jpg
3 ./assets/water.jpg
-1
20 20
2 2 2 2 2 2 2 2 2 2 2 2 2 2 2 2 2 2 2 2
2 3 3 0 0 0 0 0 0 0 0 0 0 0 0 0 0 0 0 2
2 3 3 0 0 0 0 0 0 0 0 0 0 0 0 0 0 0 0 2
2 1 1 1 1 1 1 1 1 1 1 1 0 1 0 1 0 1 0 2
2 1 1 1 1 1 1 1 1 1 1 1 1 1 1 1 1 1 1 2
2 1 1 1 1 1 1 1 1 1 1 1 1 1 1 1 1 1 1 2
2 1 1 1 1 1 1 1 1 1 1 1 1 1 1 1 1 1 1 2
2 2 2 2 2 2 2 2 2 2 2 2 2 2 2 2 2 2 2 2
2 3 3 0 0 0 0 0 0 0 0 0 0 0 0 0 0 0 0 2
2 3 3 0 0 0 0 0 0 0 0 0 0 0 0 0 0 0 0 2
2 1 1 1 1 1 1 1 1 1 1 1 0 1 0 1 0 1 0 2
2 1 1 1 1 3 1 1 1 1 1 1 1 1 1 1 1 1 1 2
2 1 1 1 1 1 1 3 3 1 1 1 1 1 1 1 1 1 1 2
2 1 1 1 1 1 1 1 1 1 1 1 1 0 1 1 1 1 1 2
2 2 2 2 2 2 2 2 2 2 2 2 2 2 2 2 2 2 2 2
2 3 3 0 0 0 0 0 0 0 0 0 0 0 0 0 0 0 0 2
2 3 3 0 0 0 0 0 0 0 0 0 0 0 0 0 0 0 0 2
2 1 1 1 1 1 1 1 1 1 1 1 0 1 0 1 0 1 0 2
2 1 1 1 1 1 1 1 1 1 1 1 1 1 1 1 1 1 1 2
2 2 2 2 2 2 2 2 2 2 2 2 2 2 2 2 2 2 2 2
-1
